20 20
XXXXXXXXXXXXXXXXXXXX
X 1XX  X232332S2332X
X22311X243X33XXX342X
X243XX2433X23XX142XX
X2342343X31X22XX2X X
XGX2X33433X1X3223X X
X11422X343X2X2XX22XX
X 21XX2333X2X322X2XX
X  1X23XX33332X3342X
X   X23X233X2X14332X
XXX  2233X3331X2XXXX
X X X X24232XXX3211X
X   X  21XXX  X1X1 X
XX    X 1  X   XX  X
X         X    X   X
X   X     XX     XXX
X X  XX    X  X    X
XX   X   X   X   X X
X X X X X        X X
XXXXXXXXXXXXXXXXXXXX
